鯵	竹筴魚
鮎	香魚
かんぱち	紅甘参
かれい	鰈魚
平目	比目魚
あんこう	鮟鱇魚
穴子	星鰻
さんま	秋刀魚
すずき	鱸魚
鯛	鯛
鰹	鰹魚
鯖	青花魚
ししゃも	柳葉魚
鮭	三文魚
鰯	沙丁魚
鰻	鰻魚
鯉	鯉魚
河豚	河豚
鮫	鯊魚
鱈	鱈魚
はも	海鰻
まぐろ	鮪魚
鱒	鱒魚
ぶり	鰤魚
子肌	鰈魚
はた	石斑
まながつお	白鯧魚
いか	花枝
たこ	章魚
甘えび	甜蝦
いくら	鮭魚卵
うに	海膽
あわび	鮑魚
とろ	鮪魚肚肉
ほたて貝	扇貝
貝柱	赤貝
ほっき貝	北寄貝
数のこ	晒乾的青魚子
なまこ	海參
かに	蟹
たらばがに	帝王蟹
かにみそ	蟹黃